{
  "Empty":
    [
      [1, 1, 1, 1, 1, 1, 1, 1, 1, 1, 1, 1],
      [1, 0, 0, 0, 0, 0, 0, 0, 0, 0, 0, 1],
      [1, 0, 0, 0, 0, 0, 0, 0, 0, 0, 0, 1],
      [1, 0, 0, 0, 0, 0, 0, 0, 0, 0, 0, 1],
      [1, 0, 0, 0, 0, 0, 0, 0, 0, 0, 0, 1],
      [1, 0, 0, 0, 0, 0, 0, 0, 0, 0, 0, 1],
      [1, 0, 0, 0, 0, 0, 0, 0, 0, 0, 0, 1],
      [1, 0, 0, 0, 0, 0, 0, 0, 0, 0, 0, 1],
      [1, 0, 0, 0, 0, 0, 0, 0, 0, 0, 0, 1],
      [1, 0, 0, 0, 0, 0, 0, 0, 0, 0, 0, 1],
      [1, 0, 0, 0, 0, 0, 0, 0, 0, 0, 0, 1],
      [1, 1, 1, 1, 1, 1, 1, 1, 1, 1, 1, 1]
    ],
"Snake and Short":
    [
      [1, 1, 1, 1, 1, 1, 1, 1, 1, 1, 1, 1],
      [1, 0, 0, 1, 0, 0, 0, 1, 0, 0, 0, 1],
      [1, 0, 0, 1, 0, 1, 0, 1, 0, 1, 0, 1],
      [1, 0, 0, 1, 0, 1, 0, 1, 0, 1, 0, 1],
      [1, 0, 0, 1, 0, 1, 0, 1, 0, 1, 0, 1],
      [1, 0, 0, 1, 0, 1, 0, 1, 0, 1, 0, 1],
      [1, 0, 0, 1, 0, 1, 0, 1, 0, 1, 0, 1],
      [1, 0, 0, 1, 0, 1, 0, 1, 0, 1, 0, 1],
      [1, 0, 0, 0, 0, 1, 0, 0, 0, 1, 0, 1],
      [1, 0, 1, 1, 1, 1, 1, 1, 1, 1, 0, 1],
      [1, 0, 0, 0, 0, 0, 0, 0, 0, 0, 0, 1],
      [1, 1, 1, 1, 1, 1, 1, 1, 1, 1, 1, 1]
    ],
"Example":
  [
    [1, 1, 1, 1, 1, 1, 1, 1, 1, 1, 1, 1],
    [1, 0, 0, 0, 0, 0, 0, 0, 0, 0, 0, 1],
    [1, 0, 1, 1, 1, 1, 1, 1, 0, 1, 1, 1],
    [1, 0, 1, 0, 0, 0, 0, 0, 0, 0, 0, 1],
    [1, 0, 1, 0, 1, 1, 1, 1, 1, 1, 0, 1],
    [1, 0, 1, 0, 1, 0, 0, 0, 0, 0, 0, 1],
    [1, 0, 0, 0, 1, 1, 0, 1, 1, 1, 0, 1],
    [1, 0, 1, 0, 0, 0, 0, 1, 0, 1, 1, 1],
    [1, 0, 1, 1, 0, 1, 0, 0, 0, 0, 0, 1],
    [1, 0, 1, 0, 0, 1, 1, 1, 1, 1, 0, 1],
    [1, 0, 0, 0, 1, 1, 0, 0, 0, 0, 0, 1],
    [1, 1, 1, 1, 1, 1, 1, 1, 1, 1, 1, 1]
  ],
"With dead ends":
    [
      [1, 1, 1, 1, 1, 1, 1, 1, 1, 1, 1, 1],
      [1, 0, 0, 0, 0, 0, 0, 0, 0, 0, 0, 1],
      [1, 0, 1, 1, 1, 1, 1, 1, 1, 1, 0, 1],
      [1, 0, 1, 0, 0, 0, 0, 0, 0, 1, 0, 1],
      [1, 0, 1, 0, 1, 1, 1, 1, 0, 1, 0, 1],
      [1, 0, 1, 0, 1, 0, 0, 1, 1, 1, 0, 1],
      [1, 0, 1, 0, 0, 0, 0, 0, 0, 1, 0, 1],
      [1, 0, 1, 0, 1, 1, 1, 1, 0, 1, 0, 1],
      [1, 0, 1, 0, 0, 0, 0, 1, 0, 1, 0, 1],
      [1, 0, 1, 1, 1, 1, 0, 1, 0, 1, 1, 1],
      [1, 0, 0, 0, 0, 0, 0, 1, 0, 0, 0, 1],
      [1, 1, 1, 1, 1, 1, 1, 1, 1, 1, 1, 1]
    ]
}
